12
12
eeeeeeeeeeeeeeee
e              e
e              e
e              e
e             Fe
e    e        ee
eS   e        ee
eeeeeeeeeeeeeeee